IP, Original Hostname, Modified Hostname, IP Geolocation, Cert Geolocations, Packets, Bytes, TxPackets, TxBytes, RxPackets, RxBytes
44.199.80.228,avs-alexa-14-na.amazon.com,avs-alexa-14-na.amazon.com,United States,US;US;US;US;US;US;US,24800,3773440,15030,1704307,9770,2069133
18.160.2.68,d1s31zyz7dcc2d.cloudfront.prod.ota-cloudfront.net,d1s31zyz7dcc2d.cloudfront.prod.ota-cloudfront.net,United States,US;US;US;US;US,23182,103837930,16267,103362624,6915,475306
3.223.181.245,avs-alexa-14-na.amazon.com,avs-alexa-14-na.amazon.com,United States,US;US;US;US;US;US;US,19592,2992774,11744,1348154,7848,1644620
3.217.147.217,avs-alexa-14-na.amazon.com,avs-alexa-14-na.amazon.com,United States,US;US;US;US;US;US;US,19549,3168576,11895,1366411,7654,1802165
3.162.122.67,api.amazonalexa.com,api.amazonalexa.com,United States,US;US;US;US;US;US;US,15944,6021461,6567,4773765,9377,1247696
108.138.74.73,api.amazonalexa.com,api.amazonalexa.com,United States,US;US;US;US;US;US;US,15609,6010133,6328,4779786,9281,1230347
54.164.163.115,device-metrics-us-2.amazon.com,device-metrics-us-2.amazon.com,United States,US;US;US;US;US,12842,5454005,5490,1830549,7352,3623456
3.162.107.67,api.amazonalexa.com,api.amazonalexa.com,United States,US;US;US;US;US;US;US,12615,4979519,5094,3988292,7521,991227
18.155.255.74,api.amazonalexa.com,api.amazonalexa.com,United States,US;US;US;US;US;US;US,12315,4803386,5017,3834577,7298,968809
35.175.71.102,avs-alexa-14-na.amazon.com,avs-alexa-14-na.amazon.com,United States,US;US;US;US;US;US;US,12154,1824542,7279,854854,4875,969688
54.221.200.137,device-metrics-us-2.amazon.com,device-metrics-us-2.amazon.com,United States,US;US;US;US;US,11208,4782740,4766,1595616,6442,3187124
44.198.224.47,device-metrics-us-2.amazon.com,device-metrics-us-2.amazon.com,United States,US;US;US;US;US,10977,4640956,4706,1570200,6271,3070756
54.167.177.211,avs-alexa-14-na.amazon.com,avs-alexa-14-na.amazon.com,United States,US;US;US;US;US;US;US,10762,1777677,6482,771483,4280,1006194
18.67.73.76,api.amazonalexa.com,api.amazonalexa.com,United States,US;US;US;US;US;US;US,10356,4048597,4225,3235741,6131,812856
54.242.128.35,device-metrics-us-2.amazon.com,device-metrics-us-2.amazon.com,United States,US;US;US;US;US,9401,3951595,4003,1358457,5398,2593138
54.205.24.65,device-metrics-us-2.amazon.com,device-metrics-us-2.amazon.com,United States,US;US;US;US;US,8975,3782675,3831,1299042,5144,2483633
34.237.111.59,device-metrics-us-2.amazon.com,device-metrics-us-2.amazon.com,United States,US;US;US;US;US,8393,3604722,3571,1207344,4822,2397378
54.166.21.152,device-metrics-us-2.amazon.com,device-metrics-us-2.amazon.com,United States,US;US;US;US;US,8256,3525150,3533,1188819,4723,2336331
192.168.1.106,None,None,None,None,7924,1605138,5024,1363336,2900,241802
54.91.103.251,device-metrics-us-2.amazon.com,device-metrics-us-2.amazon.com,United States,US;US;US;US;US,7219,3069790,3054,1039971,4165,2029819
44.199.138.71,device-metrics-us-2.amazon.com,device-metrics-us-2.amazon.com,United States,US;US;US;US;US,7162,2971614,3056,1045074,4106,1926540
52.202.2.34,device-metrics-us-2.amazon.com,device-metrics-us-2.amazon.com,United States,US;US;US;US;US,6974,2963840,2964,991167,4010,1972673
18.214.180.6,device-metrics-us-2.amazon.com,device-metrics-us-2.amazon.com,United States,US;US;US;US;US,6626,2768645,2815,960033,3811,1808612
34.195.175.66,device-metrics-us-2.amazon.com,device-metrics-us-2.amazon.com,United States,US;US;US;US;US,6405,2652005,2743,933753,3662,1718252
50.19.211.146,prod.amcs-tachyon.com,prod.amcs-tachyon.com,United States,US;US;US;US;US;US;US,6218,551137,2081,208051,4137,343086
54.243.58.104,device-metrics-us-2.amazon.com,device-metrics-us-2.amazon.com,United States,US;US;US;US;US,6117,2552862,2615,887784,3502,1665078
44.199.52.214,device-metrics-us-2.amazon.com,device-metrics-us-2.amazon.com,United States,US;US;US;US;US,6043,2575994,2584,859395,3459,1716599
3.227.83.236,device-metrics-us-2.amazon.com,device-metrics-us-2.amazon.com,United States,US;US;US;US;US,6000,2493993,2587,880737,3413,1613256
52.7.51.52,ec2-52-7-51-52.compute-1.amazonaws.com.,ec2-52-7-51-52.compute-1.amazonaws.com.,United States,None,5862,510988,1984,191053,3878,319935
52.20.206.121,device-metrics-us-2.amazon.com,device-metrics-us-2.amazon.com,United States,US;US;US;US;US,5618,2332368,2410,815889,3208,1516479
18.160.44.74,api.amazonalexa.com,api.amazonalexa.com,United States,US;US;US;US;US;US;US,4792,1881117,1934,1503328,2858,377789
54.173.30.23,prod.amcs-tachyon.com,prod.amcs-tachyon.com,United States,US;US;US;US;US;US;US,4668,414992,1588,159124,3080,255868
54.157.203.98,device-metrics-us-2.amazon.com,device-metrics-us-2.amazon.com,United States,US;US;US;US;US,4595,1886083,1968,679869,2627,1206214
44.193.236.65,device-metrics-us-2.amazon.com,device-metrics-us-2.amazon.com,United States,US;US;US;US;US,4564,1826247,1965,679311,2599,1146936
52.1.13.168,A4ZXE0RM7LQ7A.us-east-1.prod.service.minerva.devices.a2z.com,A4ZXE0RM7LQ7A.us-east-1.prod.service.minerva.devices.a2z.com,United States,US;US;US;US;US;US;US,4098,3024851,1686,327393,2412,2697458
35.168.107.239,A4ZXE0RM7LQ7A.us-east-1.prod.service.minerva.devices.a2z.com,A4ZXE0RM7LQ7A.us-east-1.prod.service.minerva.devices.a2z.com,United States,US;US;US;US;US;US;US,3728,2610705,1545,280022,2183,2330683
52.1.112.15,prod.amcs-tachyon.com,prod.amcs-tachyon.com,United States,US;US;US;US;US;US;US,2875,258683,982,100738,1893,157945
52.7.177.117,A4ZXE0RM7LQ7A.us-east-1.prod.service.minerva.devices.a2z.com,A4ZXE0RM7LQ7A.us-east-1.prod.service.minerva.devices.a2z.com,United States,US;US;US;US;US;US;US,2749,2138518,1109,228197,1640,1910321
18.154.230.60,d3p8zr0ffa9t17.cloudfront.net,d3p8zr0ffa9t17.cloudfront.net,United States,None,2690,362343,1345,223270,1345,139073
18.154.230.133,d3p8zr0ffa9t17.cloudfront.net,d3p8zr0ffa9t17.cloudfront.net,United States,None,2640,355608,1320,219120,1320,136488
18.154.230.19,d3p8zr0ffa9t17.cloudfront.net,d3p8zr0ffa9t17.cloudfront.net,United States,None,2600,350220,1300,215800,1300,134420
18.154.230.100,d3p8zr0ffa9t17.cloudfront.net,d3p8zr0ffa9t17.cloudfront.net,United States,None,2482,334188,1241,205906,1241,128282
3.223.143.190,A4ZXE0RM7LQ7A.us-east-1.prod.service.minerva.devices.a2z.com,A4ZXE0RM7LQ7A.us-east-1.prod.service.minerva.devices.a2z.com,United States,US;US;US;US;US;US;US,2109,1459860,841,172326,1268,1287534
13.35.91.74,api.amazonalexa.com,api.amazonalexa.com,United States,US;US;US;US;US;US;US,1995,742752,822,587244,1173,155508
34.233.92.120,A4ZXE0RM7LQ7A.us-east-1.prod.service.minerva.devices.a2z.com,A4ZXE0RM7LQ7A.us-east-1.prod.service.minerva.devices.a2z.com,United States,US;US;US;US;US;US;US,1917,1629263,776,174184,1141,1455079
18.173.129.67,api.amazonalexa.com,api.amazonalexa.com,United States,US;US;US;US;US;US;US,1899,735432,776,586806,1123,148626
3.221.133.8,A4ZXE0RM7LQ7A.us-east-1.prod.service.minerva.devices.a2z.com,A4ZXE0RM7LQ7A.us-east-1.prod.service.minerva.devices.a2z.com,United States,US;US;US;US;US;US;US,1861,1438360,816,168941,1045,1269419
224.0.0.251,mdns.mcast.net.,mdns.mcast.net.,None,None,1800,183201,0,0,1800,183201
3.162.130.154,d3p8zr0ffa9t17.cloudfront.net,d3p8zr0ffa9t17.cloudfront.net,United States,None,1762,237188,881,146130,881,91058
3.162.130.150,d3p8zr0ffa9t17.cloudfront.net,d3p8zr0ffa9t17.cloudfront.net,United States,None,1734,233286,867,143713,867,89573
3.228.250.146,A4ZXE0RM7LQ7A.us-east-1.prod.service.minerva.devices.a2z.com,A4ZXE0RM7LQ7A.us-east-1.prod.service.minerva.devices.a2z.com,United States,US;US;US;US;US;US;US,1701,1304699,714,153281,987,1151418
3.162.130.91,d3p8zr0ffa9t17.cloudfront.net,d3p8zr0ffa9t17.cloudfront.net,United States,None,1660,223594,830,137772,830,85822
3.162.130.209,d3p8zr0ffa9t17.cloudfront.net,d3p8zr0ffa9t17.cloudfront.net,United States,None,1630,219551,815,135280,815,84271
108.139.43.67,api.amazonalexa.com,api.amazonalexa.com,United States,US;US;US;US;US;US;US,1629,634442,657,504737,972,129705
52.72.230.1,A4ZXE0RM7LQ7A.us-east-1.prod.service.minerva.devices.a2z.com,A4ZXE0RM7LQ7A.us-east-1.prod.service.minerva.devices.a2z.com,United States,US;US;US;US;US;US;US,1527,1023263,656,129320,871,893943
3.232.74.135,A4ZXE0RM7LQ7A.us-east-1.prod.service.minerva.devices.a2z.com,A4ZXE0RM7LQ7A.us-east-1.prod.service.minerva.devices.a2z.com,United States,US;US;US;US;US;US;US,1458,992002,588,124960,870,867042
18.213.161.240,A4ZXE0RM7LQ7A.us-east-1.prod.service.minerva.devices.a2z.com,A4ZXE0RM7LQ7A.us-east-1.prod.service.minerva.devices.a2z.com,United States,US;US;US;US;US;US;US,1443,1010877,599,125486,844,885391
52.85.138.76,api.amazonalexa.com,api.amazonalexa.com,United States,US;US;US;US;US;US;US,1368,507557,561,398391,807,109166
23.21.145.114,A4ZXE0RM7LQ7A.us-east-1.prod.service.minerva.devices.a2z.com,A4ZXE0RM7LQ7A.us-east-1.prod.service.minerva.devices.a2z.com,United States,US;US;US;US;US;US;US,1363,1039986,567,104990,796,934996
3.220.143.138,A4ZXE0RM7LQ7A.us-east-1.prod.service.minerva.devices.a2z.com,A4ZXE0RM7LQ7A.us-east-1.prod.service.minerva.devices.a2z.com,United States,US;US;US;US;US;US;US,1363,914532,542,122592,821,791940
54.224.227.209,A4ZXE0RM7LQ7A.us-east-1.prod.service.minerva.devices.a2z.com,A4ZXE0RM7LQ7A.us-east-1.prod.service.minerva.devices.a2z.com,United States,US;US;US;US;US;US;US,1346,933225,566,117445,780,815780
54.243.177.4,A4ZXE0RM7LQ7A.us-east-1.prod.service.minerva.devices.a2z.com,A4ZXE0RM7LQ7A.us-east-1.prod.service.minerva.devices.a2z.com,United States,US;US;US;US;US;US;US,1236,792916,504,113056,732,679860
52.0.132.2,A4ZXE0RM7LQ7A.us-east-1.prod.service.minerva.devices.a2z.com,A4ZXE0RM7LQ7A.us-east-1.prod.service.minerva.devices.a2z.com,United States,US;US;US;US;US;US;US,1201,761532,471,104754,730,656778
34.195.75.243,A4ZXE0RM7LQ7A.us-east-1.prod.service.minerva.devices.a2z.com,A4ZXE0RM7LQ7A.us-east-1.prod.service.minerva.devices.a2z.com,United States,US;US;US;US;US;US;US,1178,787700,523,102086,655,685614
174.129.99.38,A4ZXE0RM7LQ7A.us-east-1.prod.service.minerva.devices.a2z.com,A4ZXE0RM7LQ7A.us-east-1.prod.service.minerva.devices.a2z.com,United States,US;US;US;US;US;US;US,1135,749108,488,93977,647,655131
54.156.53.87,A4ZXE0RM7LQ7A.us-east-1.prod.service.minerva.devices.a2z.com,A4ZXE0RM7LQ7A.us-east-1.prod.service.minerva.devices.a2z.com,United States,US;US;US;US;US;US;US,1107,730310,425,89410,682,640900
52.6.74.78,A4ZXE0RM7LQ7A.us-east-1.prod.service.minerva.devices.a2z.com,A4ZXE0RM7LQ7A.us-east-1.prod.service.minerva.devices.a2z.com,United States,US;US;US;US;US;US;US,1087,741775,464,99156,623,642619
107.22.14.153,A4ZXE0RM7LQ7A.us-east-1.prod.service.minerva.devices.a2z.com,A4ZXE0RM7LQ7A.us-east-1.prod.service.minerva.devices.a2z.com,United States,US;US;US;US;US;US;US,1064,684959,435,96278,629,588681
54.80.106.159,A4ZXE0RM7LQ7A.us-east-1.prod.service.minerva.devices.a2z.com,A4ZXE0RM7LQ7A.us-east-1.prod.service.minerva.devices.a2z.com,United States,US;US;US;US;US;US;US,1049,756745,423,95546,626,661199
23.21.206.89,A4ZXE0RM7LQ7A.us-east-1.prod.service.minerva.devices.a2z.com,A4ZXE0RM7LQ7A.us-east-1.prod.service.minerva.devices.a2z.com,United States,US;US;US;US;US;US;US,1022,606506,407,82110,615,524396
52.206.63.5,A4ZXE0RM7LQ7A.us-east-1.prod.service.minerva.devices.a2z.com,A4ZXE0RM7LQ7A.us-east-1.prod.service.minerva.devices.a2z.com,United States,US;US;US;US;US;US;US,1019,692283,398,81492,621,610791
8.8.8.8,dns.google.,dns.google.,United States,None,1014,126412,507,82867,507,43545
34.237.132.195,A4ZXE0RM7LQ7A.us-east-1.prod.service.minerva.devices.a2z.com,A4ZXE0RM7LQ7A.us-east-1.prod.service.minerva.devices.a2z.com,United States,US;US;US;US;US;US;US,1006,644164,412,88600,594,555564
3.215.39.39,A4ZXE0RM7LQ7A.us-east-1.prod.service.minerva.devices.a2z.com,A4ZXE0RM7LQ7A.us-east-1.prod.service.minerva.devices.a2z.com,United States,US;US;US;US;US;US;US,998,751874,448,85008,550,666866
34.231.189.116,A4ZXE0RM7LQ7A.us-east-1.prod.service.minerva.devices.a2z.com,A4ZXE0RM7LQ7A.us-east-1.prod.service.minerva.devices.a2z.com,United States,US;US;US;US;US;US;US,946,746006,392,75239,554,670767
3.216.253.228,A4ZXE0RM7LQ7A.us-east-1.prod.service.minerva.devices.a2z.com,A4ZXE0RM7LQ7A.us-east-1.prod.service.minerva.devices.a2z.com,United States,US;US;US;US;US;US;US,885,572596,368,67264,517,505332
34.192.220.80,A4ZXE0RM7LQ7A.us-east-1.prod.service.minerva.devices.a2z.com,A4ZXE0RM7LQ7A.us-east-1.prod.service.minerva.devices.a2z.com,United States,US;US;US;US;US;US;US,803,536091,315,63802,488,472289
18.207.54.203,A4ZXE0RM7LQ7A.us-east-1.prod.service.minerva.devices.a2z.com,A4ZXE0RM7LQ7A.us-east-1.prod.service.minerva.devices.a2z.com,United States,US;US;US;US;US;US;US,798,567638,347,72110,451,495528
52.44.167.205,A4ZXE0RM7LQ7A.us-east-1.prod.service.minerva.devices.a2z.com,A4ZXE0RM7LQ7A.us-east-1.prod.service.minerva.devices.a2z.com,United States,US;US;US;US;US;US;US,769,561521,316,63880,453,497641
34.204.243.65,A4ZXE0RM7LQ7A.us-east-1.prod.service.minerva.devices.a2z.com,A4ZXE0RM7LQ7A.us-east-1.prod.service.minerva.devices.a2z.com,United States,US;US;US;US;US;US;US,755,535392,304,69176,451,466216
54.162.190.244,A4ZXE0RM7LQ7A.us-east-1.prod.service.minerva.devices.a2z.com,A4ZXE0RM7LQ7A.us-east-1.prod.service.minerva.devices.a2z.com,United States,US;US;US;US;US;US;US,745,453442,329,58590,416,394852
18.235.197.135,A4ZXE0RM7LQ7A.us-east-1.prod.service.minerva.devices.a2z.com,A4ZXE0RM7LQ7A.us-east-1.prod.service.minerva.devices.a2z.com,United States,US;US;US;US;US;US;US,741,506150,315,63778,426,442372
52.73.91.15,A4ZXE0RM7LQ7A.us-east-1.prod.service.minerva.devices.a2z.com,A4ZXE0RM7LQ7A.us-east-1.prod.service.minerva.devices.a2z.com,United States,US;US;US;US;US;US;US,741,434141,332,58812,409,375329
52.20.35.77,A4ZXE0RM7LQ7A.us-east-1.prod.service.minerva.devices.a2z.com,A4ZXE0RM7LQ7A.us-east-1.prod.service.minerva.devices.a2z.com,United States,US;US;US;US;US;US;US,737,565031,305,63268,432,501763
174.129.165.207,det-ta-g7g.amazon.com,det-ta-g7g.amazon.com,United States,US;US;US;US;US,732,656787,272,27006,460,629781
3.212.135.104,A4ZXE0RM7LQ7A.us-east-1.prod.service.minerva.devices.a2z.com,A4ZXE0RM7LQ7A.us-east-1.prod.service.minerva.devices.a2z.com,United States,US;US;US;US;US;US;US,729,490993,330,64828,399,426165
52.72.103.43,A4ZXE0RM7LQ7A.us-east-1.prod.service.minerva.devices.a2z.com,A4ZXE0RM7LQ7A.us-east-1.prod.service.minerva.devices.a2z.com,United States,US;US;US;US;US;US;US,720,475695,290,62304,430,413391
34.197.2.60,A4ZXE0RM7LQ7A.us-east-1.prod.service.minerva.devices.a2z.com,A4ZXE0RM7LQ7A.us-east-1.prod.service.minerva.devices.a2z.com,United States,US;US;US;US;US;US;US,719,511042,295,68618,424,442424
54.197.158.192,A4ZXE0RM7LQ7A.us-east-1.prod.service.minerva.devices.a2z.com,A4ZXE0RM7LQ7A.us-east-1.prod.service.minerva.devices.a2z.com,United States,US;US;US;US;US;US;US,707,482662,310,69820,397,412842
35.171.131.47,A4ZXE0RM7LQ7A.us-east-1.prod.service.minerva.devices.a2z.com,A4ZXE0RM7LQ7A.us-east-1.prod.service.minerva.devices.a2z.com,United States,US;US;US;US;US;US;US,680,390536,286,55716,394,334820
34.198.118.136,A4ZXE0RM7LQ7A.us-east-1.prod.service.minerva.devices.a2z.com,A4ZXE0RM7LQ7A.us-east-1.prod.service.minerva.devices.a2z.com,United States,US;US;US;US;US;US;US,669,492008,276,61204,393,430804
34.192.16.177,A4ZXE0RM7LQ7A.us-east-1.prod.service.minerva.devices.a2z.com,A4ZXE0RM7LQ7A.us-east-1.prod.service.minerva.devices.a2z.com,United States,US;US;US;US;US;US;US,666,525932,278,61498,388,464434
54.172.134.242,A4ZXE0RM7LQ7A.us-east-1.prod.service.minerva.devices.a2z.com,A4ZXE0RM7LQ7A.us-east-1.prod.service.minerva.devices.a2z.com,United States,US;US;US;US;US;US;US,659,477066,285,61810,374,415256
107.22.99.156,A4ZXE0RM7LQ7A.us-east-1.prod.service.minerva.devices.a2z.com,A4ZXE0RM7LQ7A.us-east-1.prod.service.minerva.devices.a2z.com,United States,US;US;US;US;US;US;US,645,455361,271,61441,374,393920
35.170.106.229,A4ZXE0RM7LQ7A.us-east-1.prod.service.minerva.devices.a2z.com,A4ZXE0RM7LQ7A.us-east-1.prod.service.minerva.devices.a2z.com,United States,US;US;US;US;US;US;US,643,437272,256,59860,387,377412
3.208.249.246,A4ZXE0RM7LQ7A.us-east-1.prod.service.minerva.devices.a2z.com,A4ZXE0RM7LQ7A.us-east-1.prod.service.minerva.devices.a2z.com,United States,US;US;US;US;US;US;US,643,451892,287,61966,356,389926
34.192.13.52,A4ZXE0RM7LQ7A.us-east-1.prod.service.minerva.devices.a2z.com,A4ZXE0RM7LQ7A.us-east-1.prod.service.minerva.devices.a2z.com,United States,US;US;US;US;US;US;US,634,492019,265,61220,369,430799
3.217.87.82,A4ZXE0RM7LQ7A.us-east-1.prod.service.minerva.devices.a2z.com,A4ZXE0RM7LQ7A.us-east-1.prod.service.minerva.devices.a2z.com,United States,US;US;US;US;US;US;US,621,371670,243,59002,378,312668
52.87.113.159,A4ZXE0RM7LQ7A.us-east-1.prod.service.minerva.devices.a2z.com,A4ZXE0RM7LQ7A.us-east-1.prod.service.minerva.devices.a2z.com,United States,US;US;US;US;US;US;US,612,400901,261,47966,351,352935
34.202.218.137,A4ZXE0RM7LQ7A.us-east-1.prod.service.minerva.devices.a2z.com,A4ZXE0RM7LQ7A.us-east-1.prod.service.minerva.devices.a2z.com,United States,US;US;US;US;US;US;US,610,436850,251,53974,359,382876
54.89.69.55,A4ZXE0RM7LQ7A.us-east-1.prod.service.minerva.devices.a2z.com,A4ZXE0RM7LQ7A.us-east-1.prod.service.minerva.devices.a2z.com,United States,US;US;US;US;US;US;US,592,415310,234,52260,358,363050
34.202.142.223,A4ZXE0RM7LQ7A.us-east-1.prod.service.minerva.devices.a2z.com,A4ZXE0RM7LQ7A.us-east-1.prod.service.minerva.devices.a2z.com,United States,US;US;US;US;US;US;US,588,456364,239,52602,349,403762
239.255.255.250,None,None,None,None,528,78780,0,0,528,78780
52.205.8.123,A4ZXE0RM7LQ7A.us-east-1.prod.service.minerva.devices.a2z.com,A4ZXE0RM7LQ7A.us-east-1.prod.service.minerva.devices.a2z.com,United States,US;US;US;US;US;US;US,526,384879,214,44816,312,340063
3.217.242.198,A4ZXE0RM7LQ7A.us-east-1.prod.service.minerva.devices.a2z.com,A4ZXE0RM7LQ7A.us-east-1.prod.service.minerva.devices.a2z.com,United States,US;US;US;US;US;US;US,525,361296,223,45506,302,315790
18.160.14.74,api.amazonalexa.com,api.amazonalexa.com,United States,US;US;US;US;US;US;US,522,202199,217,161147,305,41052
54.236.164.208,A4ZXE0RM7LQ7A.us-east-1.prod.service.minerva.devices.a2z.com,A4ZXE0RM7LQ7A.us-east-1.prod.service.minerva.devices.a2z.com,United States,US;US;US;US;US;US;US,519,347034,203,44078,316,302956
75.101.214.154,A4ZXE0RM7LQ7A.us-east-1.prod.service.minerva.devices.a2z.com,A4ZXE0RM7LQ7A.us-east-1.prod.service.minerva.devices.a2z.com,United States,US;US;US;US;US;US;US,515,297448,222,39337,293,258111
54.235.196.32,A4ZXE0RM7LQ7A.us-east-1.prod.service.minerva.devices.a2z.com,A4ZXE0RM7LQ7A.us-east-1.prod.service.minerva.devices.a2z.com,United States,US;US;US;US;US;US;US,501,271646,195,37438,306,234208
34.204.112.11,A4ZXE0RM7LQ7A.us-east-1.prod.service.minerva.devices.a2z.com,A4ZXE0RM7LQ7A.us-east-1.prod.service.minerva.devices.a2z.com,United States,US;US;US;US;US;US;US,497,378642,211,44630,286,334012
44.210.26.46,A4ZXE0RM7LQ7A.us-east-1.prod.service.minerva.devices.a2z.com,A4ZXE0RM7LQ7A.us-east-1.prod.service.minerva.devices.a2z.com,United States,US;US;US;US;US;US;US,490,376898,205,44222,285,332676
54.80.246.0,A4ZXE0RM7LQ7A.us-east-1.prod.service.minerva.devices.a2z.com,A4ZXE0RM7LQ7A.us-east-1.prod.service.minerva.devices.a2z.com,United States,US;US;US;US;US;US;US,481,282556,187,36946,294,245610
18.165.90.74,api.amazonalexa.com,api.amazonalexa.com,United States,US;US;US;US;US;US;US,473,158988,199,121314,274,37674
34.237.168.2,A4ZXE0RM7LQ7A.us-east-1.prod.service.minerva.devices.a2z.com,A4ZXE0RM7LQ7A.us-east-1.prod.service.minerva.devices.a2z.com,United States,US;US;US;US;US;US;US,459,326930,179,42646,280,284284
54.210.218.16,A4ZXE0RM7LQ7A.us-east-1.prod.service.minerva.devices.a2z.com,A4ZXE0RM7LQ7A.us-east-1.prod.service.minerva.devices.a2z.com,United States,US;US;US;US;US;US;US,432,367384,184,42908,248,324476
35.175.15.29,A4ZXE0RM7LQ7A.us-east-1.prod.service.minerva.devices.a2z.com,A4ZXE0RM7LQ7A.us-east-1.prod.service.minerva.devices.a2z.com,United States,US;US;US;US;US;US;US,418,282146,176,36256,242,245890
18.211.16.10,A4ZXE0RM7LQ7A.us-east-1.prod.service.minerva.devices.a2z.com,A4ZXE0RM7LQ7A.us-east-1.prod.service.minerva.devices.a2z.com,United States,US;US;US;US;US;US;US,417,256814,178,36328,239,220486
34.194.133.227,A4ZXE0RM7LQ7A.us-east-1.prod.service.minerva.devices.a2z.com,A4ZXE0RM7LQ7A.us-east-1.prod.service.minerva.devices.a2z.com,United States,US;US;US;US;US;US;US,416,286452,171,41990,245,244462
54.145.27.211,prod.amcs-tachyon.com,prod.amcs-tachyon.com,United States,US;US;US;US;US;US;US,416,44546,142,20185,274,24361
34.232.197.232,A4ZXE0RM7LQ7A.us-east-1.prod.service.minerva.devices.a2z.com,A4ZXE0RM7LQ7A.us-east-1.prod.service.minerva.devices.a2z.com,United States,US;US;US;US;US;US;US,413,270168,161,35182,252,234986
52.21.73.245,A4ZXE0RM7LQ7A.us-east-1.prod.service.minerva.devices.a2z.com,A4ZXE0RM7LQ7A.us-east-1.prod.service.minerva.devices.a2z.com,United States,US;US;US;US;US;US;US,407,292374,168,35644,239,256730
35.153.59.65,A4ZXE0RM7LQ7A.us-east-1.prod.service.minerva.devices.a2z.com,A4ZXE0RM7LQ7A.us-east-1.prod.service.minerva.devices.a2z.com,United States,US;US;US;US;US;US;US,407,220472,180,30312,227,190160
3.216.15.108,A4ZXE0RM7LQ7A.us-east-1.prod.service.minerva.devices.a2z.com,A4ZXE0RM7LQ7A.us-east-1.prod.service.minerva.devices.a2z.com,United States,US;US;US;US;US;US;US,406,257347,166,35512,240,221835
52.202.137.76,A4ZXE0RM7LQ7A.us-east-1.prod.service.minerva.devices.a2z.com,A4ZXE0RM7LQ7A.us-east-1.prod.service.minerva.devices.a2z.com,United States,US;US;US;US;US;US;US,406,259738,167,41702,239,218036
34.233.130.158,A4ZXE0RM7LQ7A.us-east-1.prod.service.minerva.devices.a2z.com,A4ZXE0RM7LQ7A.us-east-1.prod.service.minerva.devices.a2z.com,United States,US;US;US;US;US;US;US,399,241757,170,35836,229,205921
34.192.221.115,A4ZXE0RM7LQ7A.us-east-1.prod.service.minerva.devices.a2z.com,A4ZXE0RM7LQ7A.us-east-1.prod.service.minerva.devices.a2z.com,United States,US;US;US;US;US;US;US,391,253767,167,35614,224,218153
44.213.182.62,A4ZXE0RM7LQ7A.us-east-1.prod.service.minerva.devices.a2z.com,A4ZXE0RM7LQ7A.us-east-1.prod.service.minerva.devices.a2z.com,United States,US;US;US;US;US;US;US,389,262758,170,35788,219,226970
3.230.107.109,A4ZXE0RM7LQ7A.us-east-1.prod.service.minerva.devices.a2z.com,A4ZXE0RM7LQ7A.us-east-1.prod.service.minerva.devices.a2z.com,United States,US;US;US;US;US;US;US,385,222801,154,34720,231,188081
34.196.11.147,A4ZXE0RM7LQ7A.us-east-1.prod.service.minerva.devices.a2z.com,A4ZXE0RM7LQ7A.us-east-1.prod.service.minerva.devices.a2z.com,United States,US;US;US;US;US;US;US,381,256103,157,34918,224,221185
34.239.217.28,A4ZXE0RM7LQ7A.us-east-1.prod.service.minerva.devices.a2z.com,A4ZXE0RM7LQ7A.us-east-1.prod.service.minerva.devices.a2z.com,United States,US;US;US;US;US;US;US,376,229845,145,34126,231,195719
54.161.161.91,A4ZXE0RM7LQ7A.us-east-1.prod.service.minerva.devices.a2z.com,A4ZXE0RM7LQ7A.us-east-1.prod.service.minerva.devices.a2z.com,United States,US;US;US;US;US;US;US,374,225298,176,36220,198,189078
3.226.110.1,A4ZXE0RM7LQ7A.us-east-1.prod.service.minerva.devices.a2z.com,A4ZXE0RM7LQ7A.us-east-1.prod.service.minerva.devices.a2z.com,United States,US;US;US;US;US;US;US,370,241232,159,35074,211,206158
44.198.222.141,A4ZXE0RM7LQ7A.us-east-1.prod.service.minerva.devices.a2z.com,A4ZXE0RM7LQ7A.us-east-1.prod.service.minerva.devices.a2z.com,United States,US;US;US;US;US;US;US,370,237177,160,35128,210,202049
54.237.184.2,A4ZXE0RM7LQ7A.us-east-1.prod.service.minerva.devices.a2z.com,A4ZXE0RM7LQ7A.us-east-1.prod.service.minerva.devices.a2z.com,United States,US;US;US;US;US;US;US,366,228236,138,27516,228,200720
34.206.214.211,A4ZXE0RM7LQ7A.us-east-1.prod.service.minerva.devices.a2z.com,A4ZXE0RM7LQ7A.us-east-1.prod.service.minerva.devices.a2z.com,United States,US;US;US;US;US;US;US,365,226158,159,35062,206,191096
52.54.58.187,A4ZXE0RM7LQ7A.us-east-1.prod.service.minerva.devices.a2z.com,A4ZXE0RM7LQ7A.us-east-1.prod.service.minerva.devices.a2z.com,United States,US;US;US;US;US;US;US,360,242724,147,34246,213,208478
35.172.38.131,A4ZXE0RM7LQ7A.us-east-1.prod.service.minerva.devices.a2z.com,A4ZXE0RM7LQ7A.us-east-1.prod.service.minerva.devices.a2z.com,United States,US;US;US;US;US;US;US,357,222966,141,33874,216,189092
52.204.162.249,A4ZXE0RM7LQ7A.us-east-1.prod.service.minerva.devices.a2z.com,A4ZXE0RM7LQ7A.us-east-1.prod.service.minerva.devices.a2z.com,United States,US;US;US;US;US;US;US,354,280709,147,28134,207,252575
35.170.129.4,A4ZXE0RM7LQ7A.us-east-1.prod.service.minerva.devices.a2z.com,A4ZXE0RM7LQ7A.us-east-1.prod.service.minerva.devices.a2z.com,United States,US;US;US;US;US;US;US,354,242316,146,34240,208,208076
34.197.162.81,A4ZXE0RM7LQ7A.us-east-1.prod.service.minerva.devices.a2z.com,A4ZXE0RM7LQ7A.us-east-1.prod.service.minerva.devices.a2z.com,United States,US;US;US;US;US;US;US,354,196594,145,27990,209,168604
34.227.237.177,A4ZXE0RM7LQ7A.us-east-1.prod.service.minerva.devices.a2z.com,A4ZXE0RM7LQ7A.us-east-1.prod.service.minerva.devices.a2z.com,United States,US;US;US;US;US;US;US,353,219563,148,34324,205,185239
54.173.158.101,A4ZXE0RM7LQ7A.us-east-1.prod.service.minerva.devices.a2z.com,A4ZXE0RM7LQ7A.us-east-1.prod.service.minerva.devices.a2z.com,United States,US;US;US;US;US;US;US,352,208882,148,28188,204,180694
255.255.255.255,None,None,None,None,348,25926,0,0,348,25926
34.234.196.234,A4ZXE0RM7LQ7A.us-east-1.prod.service.minerva.devices.a2z.com,A4ZXE0RM7LQ7A.us-east-1.prod.service.minerva.devices.a2z.com,United States,US;US;US;US;US;US;US,344,200617,149,28266,195,172351
18.210.212.45,A4ZXE0RM7LQ7A.us-east-1.prod.service.minerva.devices.a2z.com,A4ZXE0RM7LQ7A.us-east-1.prod.service.minerva.devices.a2z.com,United States,US;US;US;US;US;US;US,343,233675,134,33388,209,200287
3.227.30.202,A4ZXE0RM7LQ7A.us-east-1.prod.service.minerva.devices.a2z.com,A4ZXE0RM7LQ7A.us-east-1.prod.service.minerva.devices.a2z.com,United States,US;US;US;US;US;US;US,341,194120,146,28080,195,166040
184.73.106.63,A4ZXE0RM7LQ7A.us-east-1.prod.service.minerva.devices.a2z.com,A4ZXE0RM7LQ7A.us-east-1.prod.service.minerva.devices.a2z.com,United States,US;US;US;US;US;US;US,337,230586,158,35032,179,195554
18.232.22.81,A4ZXE0RM7LQ7A.us-east-1.prod.service.minerva.devices.a2z.com,A4ZXE0RM7LQ7A.us-east-1.prod.service.minerva.devices.a2z.com,United States,US;US;US;US;US;US;US,336,216815,128,26856,208,189959
3.209.117.130,A4ZXE0RM7LQ7A.us-east-1.prod.service.minerva.devices.a2z.com,A4ZXE0RM7LQ7A.us-east-1.prod.service.minerva.devices.a2z.com,United States,US;US;US;US;US;US;US,336,216688,147,34258,189,182430
54.196.177.111,A4ZXE0RM7LQ7A.us-east-1.prod.service.minerva.devices.a2z.com,A4ZXE0RM7LQ7A.us-east-1.prod.service.minerva.devices.a2z.com,United States,US;US;US;US;US;US;US,334,229218,140,33808,194,195410
54.210.193.118,A4ZXE0RM7LQ7A.us-east-1.prod.service.minerva.devices.a2z.com,A4ZXE0RM7LQ7A.us-east-1.prod.service.minerva.devices.a2z.com,United States,US;US;US;US;US;US;US,333,204778,133,27198,200,177580
108.138.125.194,d3p8zr0ffa9t17.cloudfront.net,d3p8zr0ffa9t17.cloudfront.net,United States,None,330,44442,165,27381,165,17061
34.195.11.125,A4ZXE0RM7LQ7A.us-east-1.prod.service.minerva.devices.a2z.com,A4ZXE0RM7LQ7A.us-east-1.prod.service.minerva.devices.a2z.com,United States,US;US;US;US;US;US;US,326,223749,143,34066,183,189683
54.84.118.144,A4ZXE0RM7LQ7A.us-east-1.prod.service.minerva.devices.a2z.com,A4ZXE0RM7LQ7A.us-east-1.prod.service.minerva.devices.a2z.com,United States,US;US;US;US;US;US;US,321,199101,133,27210,188,171891
34.237.59.67,A4ZXE0RM7LQ7A.us-east-1.prod.service.minerva.devices.a2z.com,A4ZXE0RM7LQ7A.us-east-1.prod.service.minerva.devices.a2z.com,United States,US;US;US;US;US;US;US,317,195863,135,27342,182,168521
52.20.194.35,A4ZXE0RM7LQ7A.us-east-1.prod.service.minerva.devices.a2z.com,A4ZXE0RM7LQ7A.us-east-1.prod.service.minerva.devices.a2z.com,United States,US;US;US;US;US;US;US,314,279484,130,33124,184,246360
44.198.237.39,A4ZXE0RM7LQ7A.us-east-1.prod.service.minerva.devices.a2z.com,A4ZXE0RM7LQ7A.us-east-1.prod.service.minerva.devices.a2z.com,United States,US;US;US;US;US;US;US,313,198450,128,33004,185,165446
54.83.254.153,A4ZXE0RM7LQ7A.us-east-1.prod.service.minerva.devices.a2z.com,A4ZXE0RM7LQ7A.us-east-1.prod.service.minerva.devices.a2z.com,United States,US;US;US;US;US;US;US,312,195814,124,26604,188,169210
52.205.217.56,A4ZXE0RM7LQ7A.us-east-1.prod.service.minerva.devices.a2z.com,A4ZXE0RM7LQ7A.us-east-1.prod.service.minerva.devices.a2z.com,United States,US;US;US;US;US;US;US,312,193393,125,26658,187,166735
54.157.128.18,A4ZXE0RM7LQ7A.us-east-1.prod.service.minerva.devices.a2z.com,A4ZXE0RM7LQ7A.us-east-1.prod.service.minerva.devices.a2z.com,United States,US;US;US;US;US;US;US,311,199856,125,26658,186,173198
108.138.125.198,d3p8zr0ffa9t17.cloudfront.net,d3p8zr0ffa9t17.cloudfront.net,United States,None,310,41742,155,25715,155,16027
54.86.184.230,A4ZXE0RM7LQ7A.us-east-1.prod.service.minerva.devices.a2z.com,A4ZXE0RM7LQ7A.us-east-1.prod.service.minerva.devices.a2z.com,United States,US;US;US;US;US;US;US,310,188926,114,25932,196,162994
34.197.224.184,A4ZXE0RM7LQ7A.us-east-1.prod.service.minerva.devices.a2z.com,A4ZXE0RM7LQ7A.us-east-1.prod.service.minerva.devices.a2z.com,United States,US;US;US;US;US;US;US,308,209821,120,26328,188,183493
34.225.229.108,A4ZXE0RM7LQ7A.us-east-1.prod.service.minerva.devices.a2z.com,A4ZXE0RM7LQ7A.us-east-1.prod.service.minerva.devices.a2z.com,United States,US;US;US;US;US;US;US,306,272412,120,26336,186,246076
107.22.28.41,A4ZXE0RM7LQ7A.us-east-1.prod.service.minerva.devices.a2z.com,A4ZXE0RM7LQ7A.us-east-1.prod.service.minerva.devices.a2z.com,United States,US;US;US;US;US;US;US,305,196951,121,26394,184,170557
50.19.73.171,A4ZXE0RM7LQ7A.us-east-1.prod.service.minerva.devices.a2z.com,A4ZXE0RM7LQ7A.us-east-1.prod.service.minerva.devices.a2z.com,United States,US;US;US;US;US;US;US,301,219540,115,25998,186,193542
54.210.56.174,A4ZXE0RM7LQ7A.us-east-1.prod.service.minerva.devices.a2z.com,A4ZXE0RM7LQ7A.us-east-1.prod.service.minerva.devices.a2z.com,United States,US;US;US;US;US;US;US,301,193953,114,25932,187,168021
52.54.36.84,det-ta-g7g.amazon.com,det-ta-g7g.amazon.com,United States,US;US;US;US;US,301,348777,122,17094,179,331683
18.213.189.227,A4ZXE0RM7LQ7A.us-east-1.prod.service.minerva.devices.a2z.com,A4ZXE0RM7LQ7A.us-east-1.prod.service.minerva.devices.a2z.com,United States,US;US;US;US;US;US;US,295,196858,116,26389,179,170469
44.215.64.21,A4ZXE0RM7LQ7A.us-east-1.prod.service.minerva.devices.a2z.com,A4ZXE0RM7LQ7A.us-east-1.prod.service.minerva.devices.a2z.com,United States,US;US;US;US;US;US;US,289,185643,132,33292,157,152351
209.54.180.25,api.amazon.com,api.amazon.com,United States,US;US;US;US;US,288,89835,119,66871,169,22964
52.201.102.113,A4ZXE0RM7LQ7A.us-east-1.prod.service.minerva.devices.a2z.com,A4ZXE0RM7LQ7A.us-east-1.prod.service.minerva.devices.a2z.com,United States,US;US;US;US;US;US;US,279,173074,106,25404,173,147670
34.204.131.233,A4ZXE0RM7LQ7A.us-east-1.prod.service.minerva.devices.a2z.com,A4ZXE0RM7LQ7A.us-east-1.prod.service.minerva.devices.a2z.com,United States,US;US;US;US;US;US;US,275,189830,109,25602,166,164228
52.85.150.30,d3vcwwaauek8as.cloudfront.net,d3vcwwaauek8as.cloudfront.net,United States,None,274,543523,116,527442,158,16081
18.164.121.74,api.amazonalexa.com,api.amazonalexa.com,United States,US;US;US;US;US;US;US,261,81336,112,60184,149,21152
35.168.204.160,A4ZXE0RM7LQ7A.us-east-1.prod.service.minerva.devices.a2z.com,A4ZXE0RM7LQ7A.us-east-1.prod.service.minerva.devices.a2z.com,United States,US;US;US;US;US;US;US,253,178934,100,25008,153,153926
13.225.66.162,d3p8zr0ffa9t17.cloudfront.net,d3p8zr0ffa9t17.cloudfront.net,United States,None,240,32327,120,19919,120,12408
108.138.125.14,d3p8zr0ffa9t17.cloudfront.net,d3p8zr0ffa9t17.cloudfront.net,United States,None,240,32322,120,19914,120,12408
13.225.66.84,d3p8zr0ffa9t17.cloudfront.net,d3p8zr0ffa9t17.cloudfront.net,United States,None,230,30981,115,19090,115,11891
18.235.119.188,A4ZXE0RM7LQ7A.us-east-1.prod.service.minerva.devices.a2z.com,A4ZXE0RM7LQ7A.us-east-1.prod.service.minerva.devices.a2z.com,United States,US;US;US;US;US;US;US,224,146621,92,24480,132,122141
52.94.240.240,api.amazon.com,api.amazon.com,United States,US;US;US;US;US,213,65555,87,48687,126,16868
209.54.177.157,api.amazon.com,api.amazon.com,United States,US;US;US;US;US,213,65526,87,48658,126,16868
108.138.125.193,d3p8zr0ffa9t17.cloudfront.net,d3p8zr0ffa9t17.cloudfront.net,United States,None,190,25584,95,15761,95,9823
52.46.131.184,api.amazon.com,api.amazon.com,United States,US;US;US;US;US,189,57477,77,42623,112,14854
209.54.180.27,api.amazon.com,api.amazon.com,United States,US;US;US;US;US,189,57477,77,42623,112,14854
209.54.178.164,api.amazon.com,api.amazon.com,United States,US;US;US;US;US,187,57369,77,42623,110,14746
52.85.150.196,d3vcwwaauek8as.cloudfront.net,d3vcwwaauek8as.cloudfront.net,United States,None,185,232636,56,220766,129,11870
18.160.29.74,api.amazonalexa.com,api.amazonalexa.com,United States,US;US;US;US;US;US;US,183,58004,77,42725,106,15279
192.168.1.116,None,None,None,None,173,111758,173,111758,0,0
13.32.207.108,d2zprwa9w8uwyf.cloudfront.net,d2zprwa9w8uwyf.cloudfront.net,United States,None,165,99809,54,86908,111,12901
52.46.131.209,api.amazon.com,api.amazon.com,United States,US;US;US;US;US,162,49266,66,36534,96,12732
52.94.231.169,api.amazon.com,api.amazon.com,United States,US;US;US;US;US,162,49266,68,36642,94,12624
52.46.149.29,api.amazon.com,api.amazon.com,United States,US;US;US;US;US,161,49270,66,36592,95,12678
52.119.198.189,api.amazon.com,api.amazon.com,United States,US;US;US;US;US,161,49212,67,36588,94,12624
34.202.15.246,acsechocaptiveportal.com,acsechocaptiveportal.com,United States,None,160,15664,80,7616,80,8048
209.54.178.166,api.amazon.com,api.amazon.com,United States,US;US;US;US;US,159,49104,66,36534,93,12570
209.54.178.134,api.amazon.com,api.amazon.com,United States,US;US;US;US;US,157,48996,64,36426,93,12570
3.5.10.117,dcm-allowlist-filter-prod.s3.amazonaws.com,dcm-allowlist-filter-prod.s3.amazonaws.com,United States,US;US;US;US;US;US;US,147,180816,47,173502,100,7314
52.85.150.105,d3vcwwaauek8as.cloudfront.net,d3vcwwaauek8as.cloudfront.net,United States,None,145,228461,50,219683,95,8778
13.225.66.127,d3p8zr0ffa9t17.cloudfront.net,d3p8zr0ffa9t17.cloudfront.net,United States,None,140,18858,70,11620,70,7238
52.46.146.126,api.amazon.com,api.amazon.com,United States,US;US;US;US;US,135,41084,55,30474,80,10610
3.162.93.102,d3p8zr0ffa9t17.cloudfront.net,d3p8zr0ffa9t17.cloudfront.net,United States,None,132,17642,66,10855,66,6787
54.239.27.82,api.amazon.com,api.amazon.com,United States,US;US;US;US;US,132,40917,55,30445,77,10472
52.46.149.20,api.amazon.com,api.amazon.com,United States,US;US;US;US;US,131,40839,54,30391,77,10448
3.162.93.201,d3p8zr0ffa9t17.cloudfront.net,d3p8zr0ffa9t17.cloudfront.net,United States,None,130,17511,65,10790,65,6721
52.119.198.2,api.amazon.com,api.amazon.com,United States,US;US;US;US;US,130,40785,53,30337,77,10448
13.32.207.83,d2zprwa9w8uwyf.cloudfront.net,d2zprwa9w8uwyf.cloudfront.net,United States,None,128,79535,40,69268,88,10267
13.225.66.219,d3p8zr0ffa9t17.cloudfront.net,d3p8zr0ffa9t17.cloudfront.net,United States,None,120,16162,60,9958,60,6204
52.46.128.81,api.amazon.com,api.amazon.com,United States,US;US;US;US;US,108,32873,44,24385,64,8488
52.46.149.57,api.amazon.com,api.amazon.com,United States,US;US;US;US;US,108,32844,45,24410,63,8434
52.94.241.146,api.amazon.com,api.amazon.com,United States,US;US;US;US;US,108,32844,45,24410,63,8434
52.46.131.169,api.amazon.com,api.amazon.com,United States,US;US;US;US;US,107,32790,44,24356,63,8434
44.215.139.77,softwareupdates.amazon.com,softwareupdates.amazon.com,United States,US;US;US;US;US,107,35008,44,24894,63,10114
209.54.179.88,api.amazon.com,api.amazon.com,United States,US;US;US;US;US,107,32790,44,24356,63,8434
52.3.52.176,A4ZXE0RM7LQ7A.us-east-1.prod.service.minerva.devices.a2z.com,A4ZXE0RM7LQ7A.us-east-1.prod.service.minerva.devices.a2z.com,United States,US;US;US;US;US;US;US,107,89278,45,9106,62,80172
209.54.181.4,api.amazon.com,api.amazon.com,United States,US;US;US;US;US,106,32736,44,24356,62,8380
44.240.184.205,arcus-uswest.amazon.com,arcus-uswest.amazon.com,United States,US;US;US;US;US;US;US,106,27246,44,20412,62,6834
72.21.207.143,api.amazon.com,api.amazon.com,United States,US;US;US;US;US,105,32682,44,24356,61,8326
44.215.114.101,softwareupdates.amazon.com,softwareupdates.amazon.com,United States,US;US;US;US;US,105,33860,43,23812,62,10048
52.119.198.109,api.amazon.com,api.amazon.com,United States,US;US;US;US;US,104,32628,44,24356,60,8272
209.54.177.117,api.amazon.com,api.amazon.com,United States,US;US;US;US;US,104,32628,42,24248,62,8380
52.119.198.118,api.amazon.com,api.amazon.com,United States,US;US;US;US;US,104,32628,43,24302,61,8326
54.92.151.136,A4ZXE0RM7LQ7A.us-east-1.prod.service.minerva.devices.a2z.com,A4ZXE0RM7LQ7A.us-east-1.prod.service.minerva.devices.a2z.com,United States,US;US;US;US;US;US;US,104,33038,38,8644,66,24394
209.54.177.153,api.amazon.com,api.amazon.com,United States,US;US;US;US;US,103,32574,43,24302,60,8272
3.162.93.159,d3p8zr0ffa9t17.cloudfront.net,d3p8zr0ffa9t17.cloudfront.net,United States,None,100,13470,50,8300,50,5170
3.162.93.101,d3p8zr0ffa9t17.cloudfront.net,d3p8zr0ffa9t17.cloudfront.net,United States,None,90,12123,45,7470,45,4653
44.215.115.150,dss-na.amazon.com,dss-na.amazon.com,United States,US;US;US;US;US;US;US,89,34624,32,26293,57,8331
52.85.150.204,d3vcwwaauek8as.cloudfront.net,d3vcwwaauek8as.cloudfront.net,United States,None,85,111552,19,106081,66,5471
176.32.98.108,device-messaging-na.amazon.com,device-messaging-na.amazon.com,United States,US;US;US;US;US;US;US,84,31417,33,20541,51,10876
52.119.198.101,api.amazon.com,api.amazon.com,United States,US;US;US;US;US,81,24633,33,18267,48,6366
52.46.155.112,api.amazon.com,api.amazon.com,United States,US;US;US;US;US,81,24662,33,18296,48,6366
52.119.198.186,api.amazon.com,api.amazon.com,United States,US;US;US;US;US,81,24633,33,18267,48,6366
44.215.133.149,todo-ta-g7g.amazon.com,todo-ta-g7g.amazon.com,United States,US;US;US;US;US,81,23920,35,17764,46,6156
18.160.45.68,d3p8zr0ffa9t17.cloudfront.net,d3p8zr0ffa9t17.cloudfront.net,United States,None,80,10776,40,6640,40,4136
3.212.187.249,A4ZXE0RM7LQ7A.us-east-1.prod.service.minerva.devices.a2z.com,A4ZXE0RM7LQ7A.us-east-1.prod.service.minerva.devices.a2z.com,United States,US;US;US;US;US;US;US,80,31455,30,8116,50,23339
52.94.242.236,api.amazon.com,api.amazon.com,United States,US;US;US;US;US,79,24525,33,18267,46,6258
52.46.158.193,api.amazon.com,api.amazon.com,United States,US;US;US;US;US,78,24471,32,18213,46,6258
99.84.216.64,d2ouawjonid8rv.cloudfront.net,d2ouawjonid8rv.cloudfront.net,United States,US;US;US;US;US;US;US,75,68437,22,63910,53,4527
52.37.30.201,arcus-uswest.amazon.com,arcus-uswest.amazon.com,United States,US;US;US;US;US;US;US,73,18310,31,13718,42,4592
52.46.144.254,msh.amazon.com,msh.amazon.com,United States,US;US;US;US;US;US;US,72,28836,27,23226,45,5610
13.249.39.10,ffs-provisioner-config.amazon-dss.com,ffs-provisioner-config.amazon-dss.com,United States,US;US;US;US;US;US;US,72,26187,30,20349,42,5838
209.54.179.226,msh.amazon.com,msh.amazon.com,United States,US;US;US;US;US;US;US,71,30321,24,24381,47,5940
18.160.45.16,d3p8zr0ffa9t17.cloudfront.net,d3p8zr0ffa9t17.cloudfront.net,United States,None,70,9429,35,5810,35,3619
3.230.111.127,A4ZXE0RM7LQ7A.us-east-1.prod.service.minerva.devices.a2z.com,A4ZXE0RM7LQ7A.us-east-1.prod.service.minerva.devices.a2z.com,United States,US;US;US;US;US;US;US,70,30792,25,7786,45,23006
209.54.179.227,msh.amazon.com,msh.amazon.com,United States,US;US;US;US;US;US;US,69,29388,24,23679,45,5709
52.46.131.168,msh.amazon.com,msh.amazon.com,United States,US;US;US;US;US;US;US,69,24568,26,19732,43,4836
67.220.240.92,msh.amazon.com,msh.amazon.com,United States,US;US;US;US;US;US;US,67,27239,23,21905,44,5334
3.162.93.51,d2ouawjonid8rv.cloudfront.net,d2ouawjonid8rv.cloudfront.net,United States,US;US;US;US;US;US;US,67,67884,19,63711,48,4173
44.215.133.95,dss-na.amazon.com,dss-na.amazon.com,United States,US;US;US;US;US;US;US,65,25104,23,19149,42,5955
13.32.207.48,d2zprwa9w8uwyf.cloudfront.net,d2zprwa9w8uwyf.cloudfront.net,United States,None,64,39793,20,34658,44,5135
13.32.207.122,d2zprwa9w8uwyf.cloudfront.net,d2zprwa9w8uwyf.cloudfront.net,United States,None,63,39713,20,34639,43,5074
18.160.224.74,api.amazonalexa.com,api.amazonalexa.com,United States,None,62,20186,25,14975,37,5211
44.207.13.168,acsechocaptiveportal.com,acsechocaptiveportal.com,United States,None,61,6030,30,2856,31,3174
174.129.198.40,acsechocaptiveportal.com,acsechocaptiveportal.com,United States,None,60,5874,30,2856,30,3018
52.72.222.201,acsechocaptiveportal.com,acsechocaptiveportal.com,United States,None,60,5874,30,2856,30,3018
99.84.216.152,d2ouawjonid8rv.cloudfront.net,d2ouawjonid8rv.cloudfront.net,United States,US;US;US;US;US;US;US,56,67088,24,63971,32,3117
44.215.134.203,dcape-na.amazon.com,dcape-na.amazon.com,United States,US;US;US;US;US,55,19318,22,11936,33,7382
209.54.177.154,api.amazon.com,api.amazon.com,United States,US;US;US;US;US,54,16422,22,12178,32,4244
108.138.61.34,d3p8zr0ffa9t17.cloudfront.net,d3p8zr0ffa9t17.cloudfront.net,United States,None,54,6985,27,4268,27,2717
52.46.143.123,api.amazon.com,api.amazon.com,United States,US;US;US;US;US,54,16422,22,12178,32,4244
209.54.181.98,api.amazon.com,api.amazon.com,United States,US;US;US;US;US,54,16422,22,12178,32,4244
209.54.179.93,api.amazon.com,api.amazon.com,United States,US;US;US;US;US,53,16368,22,12178,31,4190
44.215.115.210,todo-ta-g7g.amazon.com,todo-ta-g7g.amazon.com,United States,US;US;US;US;US,52,15760,22,11716,30,4044
52.119.198.106,api.amazon.com,api.amazon.com,United States,US;US;US;US;US,52,16314,22,12178,30,4136
52.45.81.130,acsechocaptiveportal.com,acsechocaptiveportal.com,United States,None,50,4895,25,2380,25,2515
3.94.156.137,acsechocaptiveportal.com,acsechocaptiveportal.com,United States,None,50,4985,25,2380,25,2605
18.164.131.179,d3p8zr0ffa9t17.cloudfront.net,d3p8zr0ffa9t17.cloudfront.net,United States,None,50,6731,25,4146,25,2585
209.54.179.232,msh.amazon.com,msh.amazon.com,United States,US;US;US;US;US;US;US,49,19397,18,15603,31,3794
18.164.115.11,d3vcwwaauek8as.cloudfront.net,d3vcwwaauek8as.cloudfront.net,United States,None,48,106978,22,104442,26,2536
54.197.49.58,ingestion.us-east-1.prod.arteries.alexa.a2z.com,ingestion.us-east-1.prod.arteries.alexa.a2z.com,United States,US;US;US;US;US;US;US,47,16470,18,12961,29,3509
67.220.240.34,msh.amazon.com,msh.amazon.com,United States,US;US;US;US;US;US;US,47,19260,17,15520,30,3740
54.239.29.32,msh.amazon.com,msh.amazon.com,United States,US;US;US;US;US;US;US,46,19177,16,15437,30,3740
209.54.179.225,msh.amazon.com,msh.amazon.com,United States,US;US;US;US;US;US;US,46,16369,17,13127,29,3242
209.54.183.179,msh.amazon.com,msh.amazon.com,United States,US;US;US;US;US;US;US,45,16315,16,13073,29,3242
52.46.145.205,msh.amazon.com,msh.amazon.com,United States,US;US;US;US;US;US;US,44,19069,15,15383,29,3686
52.46.131.214,msh.amazon.com,msh.amazon.com,United States,US;US;US;US;US;US;US,43,18231,16,14764,27,3467
44.215.129.169,dss-na.amazon.com,dss-na.amazon.com,United States,US;US;US;US;US;US;US,43,16704,15,12706,28,3998
18.238.54.67,api.amazonalexa.com,api.amazonalexa.com,United States,None,43,14878,17,10973,26,3905
108.138.82.9,d3p8zr0ffa9t17.cloudfront.net,d3p8zr0ffa9t17.cloudfront.net,United States,None,40,5388,20,3320,20,2068
18.160.45.164,d3p8zr0ffa9t17.cloudfront.net,d3p8zr0ffa9t17.cloudfront.net,United States,None,40,5388,20,3320,20,2068
3.162.152.67,api.amazonalexa.com,api.amazonalexa.com,United States,US;US;US;US;US;US;US,40,12166,18,8997,22,3169
108.156.87.76,api.amazonalexa.com,api.amazonalexa.com,United States,US;US;US;US;US;US;US,39,11769,17,8924,22,2845
18.164.106.74,api.amazonalexa.com,api.amazonalexa.com,United States,US;US;US;US;US;US;US,37,11899,15,8780,22,3119
44.225.45.107,arcus-uswest.amazon.com,arcus-uswest.amazon.com,United States,US;US;US;US;US;US;US,37,9688,15,7220,22,2468
108.156.117.73,api.amazonalexa.com,api.amazonalexa.com,United States,None,37,23114,14,20537,23,2577
54.68.57.171,arcus-uswest.amazon.com,arcus-uswest.amazon.com,United States,US;US;US;US;US;US;US,37,9188,16,6892,21,2296
52.217.139.233,alexa-hybrid-clear-policy-prod-na.s3.amazonaws.com,alexa-hybrid-clear-policy-prod-na.s3.amazonaws.com,United States,US;US;US;US;US;US;US,37,14234,15,10840,22,3394
35.166.62.210,arcus-uswest.amazon.com,arcus-uswest.amazon.com,United States,US;US;US;US;US;US;US,36,9122,16,6892,20,2230
108.138.104.73,api.amazonalexa.com,api.amazonalexa.com,United States,None,36,24293,13,21714,23,2579
54.70.5.180,arcus-uswest.amazon.com,arcus-uswest.amazon.com,United States,US;US;US;US;US;US;US,36,9122,15,6826,21,2296
35.161.96.40,arcus-uswest.amazon.com,arcus-uswest.amazon.com,United States,US;US;US;US;US;US;US,36,9122,15,6826,21,2296
44.231.61.240,arcus-uswest.amazon.com,arcus-uswest.amazon.com,United States,US;US;US;US;US;US;US,36,9122,15,6826,21,2296
35.155.9.57,arcus-uswest.amazon.com,arcus-uswest.amazon.com,United States,US;US;US;US;US;US;US,35,9056,16,6892,19,2164
54.187.92.102,arcus-uswest.amazon.com,arcus-uswest.amazon.com,United States,US;US;US;US;US;US;US,35,9056,15,6826,20,2230
18.173.130.122,d2zprwa9w8uwyf.cloudfront.net,d2zprwa9w8uwyf.cloudfront.net,United States,None,34,20025,11,17395,23,2630
52.11.127.249,arcus-uswest.amazon.com,arcus-uswest.amazon.com,United States,US;US;US;US;US;US;US,34,9002,14,6760,20,2242
52.217.141.65,device-artifacts-v2.s3.amazonaws.com,device-artifacts-v2.s3.amazonaws.com,United States,US;US;US;US;US;US;US,33,9756,13,7573,20,2183
18.164.131.162,d3p8zr0ffa9t17.cloudfront.net,d3p8zr0ffa9t17.cloudfront.net,United States,None,30,4040,15,2489,15,1551
3.210.237.141,acsechocaptiveportal.com,acsechocaptiveportal.com,United States,None,30,2937,15,1428,15,1509
18.160.45.108,d3p8zr0ffa9t17.cloudfront.net,d3p8zr0ffa9t17.cloudfront.net,United States,None,30,4041,15,2490,15,1551
108.138.82.54,d3p8zr0ffa9t17.cloudfront.net,d3p8zr0ffa9t17.cloudfront.net,United States,None,30,4041,15,2490,15,1551
34.201.186.142,acsechocaptiveportal.com,acsechocaptiveportal.com,United States,None,30,2937,15,1428,15,1509
18.164.131.9,d3p8zr0ffa9t17.cloudfront.net,d3p8zr0ffa9t17.cloudfront.net,United States,None,30,4039,15,2488,15,1551
3.218.84.31,acsechocaptiveportal.com,acsechocaptiveportal.com,United States,None,30,2937,15,1428,15,1509
52.217.88.140,dcm-allowlist-filter-prod.s3.amazonaws.com,dcm-allowlist-filter-prod.s3.amazonaws.com,United States,US;US;US;US;US;US;US,30,8342,12,6594,18,1748
52.203.60.72,acsechocaptiveportal.com,acsechocaptiveportal.com,United States,None,30,2937,15,1428,15,1509
3.224.206.139,acsechocaptiveportal.com,acsechocaptiveportal.com,United States,None,30,2937,15,1428,15,1509
108.139.28.74,api.amazonalexa.com,api.amazonalexa.com,United States,None,30,9603,12,7019,18,2584
44.215.143.151,dcape-na.amazon.com,dcape-na.amazon.com,United States,US;US;US;US;US,27,9626,11,5968,16,3658
209.54.180.44,api.amazon.com,api.amazon.com,United States,US;US;US;US;US,27,8211,11,6089,16,2122
52.119.196.31,api.amazon.com,api.amazon.com,United States,US;US;US;US;US,27,8211,11,6089,16,2122
176.32.101.46,device-messaging-na.amazon.com,device-messaging-na.amazon.com,United States,US;US;US;US;US;US;US,26,10121,11,6783,15,3338
44.215.132.234,todo-ta-g7g.amazon.com,todo-ta-g7g.amazon.com,United States,US;US;US;US;US,26,7880,11,5858,15,2022
52.46.137.255,msh.amazon.com,msh.amazon.com,United States,US;US;US;US;US;US;US,26,11198,10,9052,16,2146
52.46.141.207,msh.amazon.com,msh.amazon.com,United States,US;US;US;US;US;US;US,25,11115,9,8969,16,2146
209.54.180.2,msh.amazon.com,msh.amazon.com,United States,US;US;US;US;US;US;US,25,11144,9,8998,16,2146
52.85.61.116,ffs-provisioner-config.amazon-dss.com,ffs-provisioner-config.amazon-dss.com,United States,US;US;US;US;US;US;US,25,8795,11,6849,14,1946
52.46.128.145,msh.amazon.com,msh.amazon.com,United States,US;US;US;US;US;US;US,25,11115,9,8969,16,2146
52.46.138.235,msh.amazon.com,msh.amazon.com,United States,US;US;US;US;US;US;US,24,8253,9,6605,15,1648
13.249.39.25,ffs-provisioner-config.amazon-dss.com,ffs-provisioner-config.amazon-dss.com,United States,US;US;US;US;US;US;US,24,8419,10,6783,14,1636
209.54.179.230,msh.amazon.com,msh.amazon.com,United States,US;US;US;US;US;US;US,24,11090,8,8944,16,2146
34.237.125.195,ingestion.us-east-1.prod.arteries.alexa.a2z.com,ingestion.us-east-1.prod.arteries.alexa.a2z.com,United States,US;US;US;US;US;US;US,24,8330,9,6500,15,1830
209.54.179.224,msh.amazon.com,msh.amazon.com,United States,US;US;US;US;US;US;US,24,11061,8,8915,16,2146
52.46.147.136,msh.amazon.com,msh.amazon.com,United States,US;US;US;US;US;US;US,24,8253,9,6605,15,1648
52.46.142.117,msh.amazon.com,msh.amazon.com,United States,US;US;US;US;US;US;US,24,11061,8,8915,16,2146
209.54.183.185,msh.amazon.com,msh.amazon.com,United States,US;US;US;US;US;US;US,24,8253,9,6605,15,1648
52.46.137.107,msh.amazon.com,msh.amazon.com,United States,US;US;US;US;US;US;US,23,8170,9,6576,14,1594
209.54.183.178,msh.amazon.com,msh.amazon.com,United States,US;US;US;US;US;US;US,22,8116,8,6522,14,1594
108.138.61.102,d3p8zr0ffa9t17.cloudfront.net,d3p8zr0ffa9t17.cloudfront.net,United States,None,22,2822,11,1722,11,1100
67.220.240.35,msh.amazon.com,msh.amazon.com,United States,US;US;US;US;US;US;US,22,8116,8,6522,14,1594
52.46.145.14,msh.amazon.com,msh.amazon.com,United States,US;US;US;US;US;US;US,22,8116,8,6522,14,1594
52.46.128.80,msh.amazon.com,msh.amazon.com,United States,US;US;US;US;US;US;US,22,8116,8,6522,14,1594
209.54.179.231,msh.amazon.com,msh.amazon.com,United States,US;US;US;US;US;US;US,22,10953,7,8861,15,2092
52.94.239.41,msh.amazon.com,msh.amazon.com,United States,US;US;US;US;US;US;US,22,8116,8,6522,14,1594
209.54.183.194,msh.amazon.com,msh.amazon.com,United States,US;US;US;US;US;US;US,21,8062,7,6468,14,1594
52.94.233.60,msh.amazon.com,msh.amazon.com,United States,US;US;US;US;US;US;US,21,8062,7,6468,14,1594
54.211.181.218,ingestion.us-east-1.prod.arteries.alexa.a2z.com,ingestion.us-east-1.prod.arteries.alexa.a2z.com,United States,US;US;US;US;US;US;US,21,8007,9,6461,12,1546
18.238.59.69,d3p8zr0ffa9t17.cloudfront.net,d3p8zr0ffa9t17.cloudfront.net,United States,None,20,2689,10,1655,10,1034
108.138.61.8,d3p8zr0ffa9t17.cloudfront.net,d3p8zr0ffa9t17.cloudfront.net,United States,None,20,2688,10,1654,10,1034
3.162.159.115,d3p8zr0ffa9t17.cloudfront.net,d3p8zr0ffa9t17.cloudfront.net,United States,None,20,2696,10,1662,10,1034
54.230.244.171,d3p8zr0ffa9t17.cloudfront.net,d3p8zr0ffa9t17.cloudfront.net,United States,None,20,2694,10,1660,10,1034
54.230.139.132,d3p8zr0ffa9t17.cloudfront.net,d3p8zr0ffa9t17.cloudfront.net,United States,None,12,1477,6,894,6,583
54.230.125.126,d3p8zr0ffa9t17.cloudfront.net,d3p8zr0ffa9t17.cloudfront.net,United States,None,10,1347,5,830,5,517
13.225.189.40,d3p8zr0ffa9t17.cloudfront.net,d3p8zr0ffa9t17.cloudfront.net,United States,None,10,1346,5,829,5,517
13.225.189.62,d3p8zr0ffa9t17.cloudfront.net,d3p8zr0ffa9t17.cloudfront.net,United States,None,10,1347,5,830,5,517
44.194.145.88,acsechocaptiveportal.com,acsechocaptiveportal.com,United States,None,10,979,5,476,5,503
108.138.82.203,d3p8zr0ffa9t17.cloudfront.net,d3p8zr0ffa9t17.cloudfront.net,United States,None,10,1347,5,830,5,517
18.238.59.198,d3p8zr0ffa9t17.cloudfront.net,d3p8zr0ffa9t17.cloudfront.net,United States,None,10,1345,5,828,5,517
3.162.159.2,d3p8zr0ffa9t17.cloudfront.net,d3p8zr0ffa9t17.cloudfront.net,United States,None,10,1348,5,831,5,517
3.230.12.86,acsechocaptiveportal.com,acsechocaptiveportal.com,United States,None,10,1069,5,476,5,593
18.164.131.217,d3p8zr0ffa9t17.cloudfront.net,d3p8zr0ffa9t17.cloudfront.net,United States,None,10,1346,5,829,5,517
108.139.46.212,d3p8zr0ffa9t17.cloudfront.net,d3p8zr0ffa9t17.cloudfront.net,United States,None,10,1345,5,828,5,517
54.230.244.67,d3p8zr0ffa9t17.cloudfront.net,d3p8zr0ffa9t17.cloudfront.net,United States,None,10,1347,5,830,5,517
18.164.115.101,d3p8zr0ffa9t17.cloudfront.net,d3p8zr0ffa9t17.cloudfront.net,United States,None,10,1347,5,830,5,517
18.164.115.37,d3p8zr0ffa9t17.cloudfront.net,d3p8zr0ffa9t17.cloudfront.net,United States,None,10,1347,5,830,5,517
54.230.244.99,d3p8zr0ffa9t17.cloudfront.net,d3p8zr0ffa9t17.cloudfront.net,United States,None,10,1347,5,830,5,517
13.226.36.71,d3p8zr0ffa9t17.cloudfront.net,d3p8zr0ffa9t17.cloudfront.net,United States,None,10,1347,5,830,5,517
52.203.151.208,ntp-g7g.amazon.com,ntp-g7g.amazon.com,United States,None,6,540,3,270,3,270
224.0.0.22,igmp.mcast.net.,igmp.mcast.net.,None,None,5,278,0,0,5,278
34.236.6.206,ntp-g7g.amazon.com,ntp-g7g.amazon.com,United States,None,2,180,1,90,1,90
3.234.38.31,ntp-g7g.amazon.com,ntp-g7g.amazon.com,United States,None,2,180,1,90,1,90
34.239.12.200,ntp-g7g.amazon.com,ntp-g7g.amazon.com,United States,None,2,180,1,90,1,90
52.45.237.36,ntp-g7g.amazon.com,ntp-g7g.amazon.com,United States,None,2,180,1,90,1,90
3.214.58.173,ntp-g7g.amazon.com,ntp-g7g.amazon.com,United States,None,2,180,1,90,1,90
fe80::463d:54ff:febe:123c,None,None,None,None,300,29695,300,29695,0,0
ff02::fb,None,None,None,None,300,29695,0,0,300,29695
